【武林列传玩家武功造诣进阶级别】

　　不堪一击　　　　毫不足虑　　　　不足挂齿　　　　初学乍练　　
　　初窥门径　　　　略知一二　　　　普普通通　　　　平平淡淡　　
　　平淡无奇　　　　粗通皮毛　　　　半生不熟　　　　马马虎虎　　
　　略有小成　　　　已有小成　　　　驾轻就熟　　　　心领神会　　
　　了然於胸　　　　略有大成　　　　已有大成　　　　今非昔比　　
　　豁然贯通　　　　出类拔萃　　　　鹤立鸡群　　　　无可匹敌　　
　　技冠群雄　　　　神乎其技　　　　不可一世　　　　出神入化　　
　　傲视群雄　　　　登峰造极　　　　不寒而颤　　　　所向披靡　　
　　一代宗师　　　　神功盖世　　　　举世无双　　　　一代天骄　　
　　盖世奇才　　　　旷世高手　　　　暗藏杀机　　　　深藏不露　　
　　无与伦比　　　　空前绝后　　　　惊世骇俗　　　　震古铄今　　
　　独步江湖　　　　独霸一方　　　　雄霸天下　　　　翻江倒海　　
　　地动山摇　　　　惊天动地　　　　天旋地转　　　　鬼哭神嚎　　
　　天崩地裂　　　　天地无用　　　　神功通玄　　　　五气朝元　　
　　深不可测　　　　反璞归真　　　　佛法无边　　　　无量虚空　　
　　无穷无尽　　　　无上境界　　

【武林列传玩家武功等级进阶级别】

　　不堪一击　　　　毫不足虑　　　　不足挂齿　　　　初学乍练　　
　　初窥门径　　　　略知一二　　　　普普通通　　　　平平淡淡　　
　　平淡无奇　　　　粗通皮毛　　　　半生不熟　　　　马马虎虎　　
　　略有小成　　　　驾轻就熟　　　　心领神会　　　　了然於胸　　
　　略有大成　　　　今非昔比　　　　豁然贯通　　　　出类拔萃　　
　　神乎其技　　　　威不可当　　　　鹤立鸡群　　　　无可匹敌　　
　　技冠群雄　　　　神乎其技　　　　不可一世　　　　出神入化　　
　　傲视群雄　　　　登峰造极　　　　不寒而颤　　　　所向披靡　　
　　一代宗师　　　　神功盖世　　　　举世无双　　　　一代天骄　　
　　盖世奇才　　　　旷世高手　　　　暗藏杀机　　　　深藏不露　　
　　无与伦比　　　　空前绝后　　　　惊世骇俗　　　　震古铄今　　
　　独步江湖　　　　独霸一方　　　　雄霸天下　　　　翻江倒海　　
　　地动山摇　　　　惊天动地　　　　天旋地转　　　　鬼哭神嚎　　
　　天崩地裂　　　　天地无用　　　　神功通玄　　　　五气朝元　　
　　旷古绝伦　　　　登堂入室　　　　超凡入圣　　　　返璞归真　　
　　深不可测　　　　反璞归真　　　　佛法无边　　　　无量虚空　　
　　无穷无尽　　　　天下无敌　　

